11111
100P1
10001111
1E0C0001
11111111
