11111111111111111111
1C010000000000000001
1001000P000000000001
10010000000000000001
10000000000000000001
1000000E000001111111
100000000000010C0001
10000000000001110001
1000C000000000000001
11111111111111111111
