1111111111
10P0000C01
1111X00001
1C00000111
100000X001
10X00000C1
1000E00001
1111111111
